111111111111
1002000P0001
111111000001
10EC00000001
111111111111
