111111111111
100E000P0001
111111000001
10E10C000001
111111111111
