111111111111
1C10000P0001
111000000001
10E000000001
111111111111
