111111111111
1000000P0001
111111111111
10EC00000001
111111111111
