111111111111
1000000P0001
111111000001
10E1C0000001
111111111111
