111111111111
1000000P000K
111111000001
10EC00000001
111111111111
