111111111111
1000011P1001
111111111001
10EC00000001
111111111111
