111111111111
1000F00P0001
111111000001
10EC00000001
111111111111
