111111111111
1000000P001
11111100001
10EC0000001
111111111111
