1111111111111111111111111111111111111111111111111111111111111
100000000C0000000000000000000000000000000000000000P1111111001
10E0000000000000000000000000000000000000000000000000000000001
1111111111111111111111111111111111111111111111111111111111111
