111111111111
1CCCCCCPCCC1
111111CCCCC1
1CECCCCCCCC1
111111111111
