11111111111111111111111111111111111
1C00000P000XC0X1111XC00000011111111
111111000101000X1111111100X0C011111
1000011101000X000000011110C00011111
1000001101110000000001110000C111111
10000000000000000000010000000000001
10C10000000000000000001000000000001
10001100000000000000001100000C00001
1XX00111000000X00000000011000000001
10C0000100000000X000000001000000001
10000X0110X1X111000X00000100C000001
10000011000000010000000000X00000001
100C01100C0C000110000X0000C00000001
11111100000000001000000000111111111
10E0000000000000X0000000C01XXX00001
11111111111111111111111111111111111
