11111
1P001
10001
10CE1
11111
